11111111111111111
11111P01111111111
10000000000000001
10000000000000001
100000C0000000001
10001111110000001
1111111111110E011
11111111111111111