11111111111111111111
111C0000C11111111E11
1P1000000111C0000011
101C0000C11100000C11
101111100111C0111111
1000C000011100111111
11011100111100C00011
10011100111111110011
1C1111C0000000C00011
11111111111111111111