11111111111111111
11111P01111111111
10000000000000001
10000000000000001
10000000000000001
1E111111110C00001
1C111111111100011
11111111111111111