11111111111111111
11111P01111111111
10000000000000001
10000000000000001
10000000000000001
10C01111110C00001
1111111111110E011
11111111111111111